11111111111111
10010000000C11
10000111110011
1P0011E000X011
11111111111111