1111111111111111111111111111
1P01000000001000000000100E01
1001000100001000001000100001
1001000100001000001000100001
10010C010C00100C0010C0100C01
1001000100001000001000100001
1000000100000000001000000001
1111111111111111111111111111