111111111
1P00000E1
1C0000001
111111111