1111111111111111111111111
1111111111111111111111111
11P000010000C000000000001
100001111110000000C000001
100001000010C0C0000000001
100001E0000000000C000C001
1111111111111111111111111
