11111111111111
10010000000C11
10000111110011
10P011E000X011
11111111111111