1111110111111111111
10010000000C0000001
00000111110C0C00000
10P011E00000C000C01
1111111111110111111