1111111111111111111111111111
1PCCCCCC0000000000E111111111
1111111111111111111111111111