111111111
1P000C001
10000C0E1
11111111